30 20
0 0 0 0 0 0 0 0 0 0 0 0 0 0 0 0 0 0 0 0 
0 w w w w w w w w w w w w w w w w w w 0 
0 w 0 0 0 0 0 0 0 0 0 0 0 0 0 0 0 0 w 0 
0 w 0 0 0 0 0 0 0 0 0 0 0 0 0 0 0 0 w 0 
0 w 0 0 0 0 0 0 0 0 0 0 0 0 0 0 0 0 w 0 
0 w 0 0 0 0 0 0 0 0 0 0 0 0 0 0 0 0 w 0 
0 w 0 0 0 0 0 0 0 0 0 0 0 0 0 0 0 0 w 0 
0 w 0 0 0 0 0 0 w w w w w 0 0 0 0 0 w 0 
0 w 0 0 0 0 0 0 w 0 0 0 0 0 0 0 0 0 w 0 
0 w 0 0 0 0 0 0 w 0 0 0 0 0 0 0 0 0 w 0 
0 w 0 0 0 0 0 0 w 0 0 0 0 0 0 0 0 0 w 0 
0 w 0 0 0 0 0 0 w w w w w 0 0 0 0 0 w 0 
0 w 0 0 0 0 0 0 0 0 0 0 0 0 0 0 0 0 w 0 
0 w 0 0 0 0 0 0 0 0 0 0 0 0 0 0 0 0 w 0 
0 w 0 0 0 0 0 0 0 0 0 0 0 0 0 0 0 0 w 0 
0 w 0 0 0 0 0 0 0 0 0 0 0 0 0 0 0 0 w 0 
0 w 0 0 0 0 0 0 0 0 0 0 0 0 0 0 0 0 w 0 
0 w 0 0 0 0 0 0 0 0 0 0 0 0 0 0 0 0 w 0 
0 w 0 0 0 0 0 0 0 0 0 0 0 0 0 0 0 0 w 0 
0 w 0 0 0 0 0 0 0 0 0 0 0 0 0 0 0 0 w 0 
0 w 0 0 0 0 0 0 0 0 0 0 0 0 0 0 0 0 w 0 
0 w 0 0 0 0 0 0 0 0 0 0 0 0 0 0 0 0 w 0 
0 w 0 0 0 0 0 w w w w w w w 0 0 0 0 w 0
0 w 0 0 0 0 0 w 0 0 0 0 0 0 0 0 0 0 w 0 
0 w 0 0 0 0 0 w 0 0 0 0 0 0 0 0 0 0 w 0 
0 w 0 0 w w w w 0 0 0 0 0 0 0 0 0 0 w 0 
0 w 0 0 0 0 0 0 0 0 0 0 0 0 0 0 0 0 w 0 
0 w 0 0 0 0 0 0 0 0 0 0 0 0 0 0 0 0 w 0
0 w w w w w w w w w w w w w w w w w w 0 
0 0 0 0 0 0 0 0 0 0 0 0 0 0 0 0 0 0 0 0 